けんきゅうします	nghiên cứu
おくれます	chậm, muộn
せいひん		sản phẩm
おきます		đặt, để
げんご		ngôn ngữ, tiếng
カタログ		cuốn catalo
ふく		quần áo, trang phục
センター		trung tâm
うんてんしゅ	người lái xe
ストア		cửa hàng, cửa hiệu
たちます		đứng
すわります	ngồi
うります		bán
やりかた		cách làm, cách chế tạo
すみます		sống, sinh sống
おかねもち	đại gia, người giàu có
しゅしょう	thủ tướng	
ニュース		tin tức
あぶない		nguy hiểm, nguy cấp
かんごし		y tá, hộ lý
つくります	làm, rạo ra
ゴミ		rác
うまれます	được sinh ra
とります		chụp (ảnh)
じゅうしょ	địa chỉ
ふかい		sâu
あさい		nông, cạn
うんてんします	lái xe
ところ		chỗ, địa điểm
どくしん		độc thân
しゅっちょう	sự đi công tác	
みみ		cái tai
つかいます	sử dụng
いろいろ		đủ loại, đủ thứ
	
1. ～ても　いいです       =>     Làm ... cũng được
	=>  Diễn tả sự đồng ý cho phép ai làm một điều gì đó 
                hay biểu thị ý “một việc dù có làm cũng không sao”.

2. ～ては　いけません   =>    Không được làm ...
	=>   Mẫu câu này biểu thị ý nghĩa "cấm" hay "không được" làm việc gì.
	=>   Vては　いけません」được dùng rất nhiều trong cuộc sống hàng ngày, 
	ở các biển chỉ dẫn, nhãn hiệu, hay hội thoại thông thường, thể hiện sự cấm chỉ, 
	nói với người khác không được làm việc gì đó.

*** 1. Cách diễn đạt trạng thái tiếp diễn    
	
	Cấu trúc	:	Động từ thể て + います
	Giải thích	:	 
	+) Mẫu câu này để nói về một trạng thái (là kết quả của hành động 
	xảy ra trong quá khứ) vẫn còn lại, vẫn tiếp diễn ở hiện tại.	

*** 2. Cách diễn tả tập quán

*** 3. しります
	Giải thích:
		+)Động từ「しります」có nghĩa là biết.
		+)Khi muốn biểu thị ý nghĩa mình hoặc ai đó có kiến thức hoặc hiểu biết 
		về một điều gì đó dùng「しって　います」.
	Chú ý:
		*Không nói「しっていません 」(X) mà chỉ đơn giản là「しりません」. 

